
NO        nononononononoonnonono 

                       SO   sososososososososososososossoos


EA                                                                   eaeaeaeaeaeaeaeaeae








WE wewewewewewwe
F 344,233,222
C 111,233,444



1111111111
111111
1111111111111111111111111111111111111
1111111111111111111111111111111111111111111111111111111
11110000000000000000000000000000000000000000000000001111
1111111111111111111000000000000000000001111111111111111
11111111111111111111111111111111N111111111111111111111
1111000000000000000000000000000000000000000011111111
11000000000000000000000000000000000000000000011111111111111
11111111111111111111111111111111111111111111111111111
