                                    








				                                          
				     NO               ./wall_texture/wall_texture_north.xpm
SO ./wall_texture/wall_texture_south.xpm
WE                 ./wall_texture/wall_texture_west.xpm


EA ./wall_texture/wall_texture_east.xpm

F                   222,255,2147483647
C 0,255,255

        1111111111111111111111111
        1000000000110000000000001
        1000000000110000000000001
        1000000000110000000000001
        1000000000110000000000001
        1000000000110000000000001
        1001000000000000000000001
111111111011000001110000000000001
110000000000000000000000100011111
10000000000000001100000010001
100000000000000011001000100011
11000001110101011111011110N0111
11110111 1110101 101111010001
11111111 1111111 111111111111
11111111
11111111
11111111
1111
