




NO        nononononononoonnonono 
















                       SO   sososososososososososososossoos








EA                                                                   eaeaeaeaeaeaeaeaeae




                                                                                                                 WE wewewewewewwe
F 255,255,255
C 344,233,222





111111111111111111111111
111111111111111111111111111111111111111111
111111111111111000000000000000000000111
1111111111111111111100000000000000000111111111
1111111111000000000000000000000000000000000011
1111111N000000000000000000000000000000000000011
1111111110111111111111111111111111111111111111
11111111111
1
1
11111111111111111111111111
1111111
1111111111111111111111111111111111
111111111110111111111111110000001111
11111111111000000000000000000111111111
111111111110000000000000000111111111111111111111111111111111111
111111111111111111111111111111111111111111111111111111111111111
