NO ./wall_texture/wall_texture_north.xpm
SO ./wall_texture/wall_texture_south.xpm
WE                 ./wall_texture/wall_texture_west.xpm


EA ./wall_texture/wall_texture_east.xpm

F                   0,0,0
C 255,255,255

        1111111111111111111111111
        1000000000110000000000001
        1011000001110000000000001
        1001000000000000000000001
111111111011000001110000000000001
100000000011000001110111101111111
11110111111111011100000010001
11110111111111011101010010001
11000000110101011100000010001
10000000000000001100000010001
100000000000000011001000100011
11000001110101011111011110N0111
11110111 1110101 101111010001
11111111 1111111 111111111111
11111111
11111111
11111111

