NO ./texture/north_texture.xpm
SO ./texture/south_texture.xpm
WE ./texture/west_texture.xpm
EA ./texture/east_texture.xpm

F 22220,100,0
C 225,30,0

1111111
1111111
1N00111
101011
11111
