
NO        nononononononoonnonono 


                       SO   sososososososososososososossoos


EA                                                                   eaeaeaeaeaeaeaeaeae








WE wewewewewewwe
F 344,233,222
C 111,233,444

111 
11111111111111111111111111
11111111111111
1111111111111111111                     
111111111111111111111111
111111111
111111111111111111111111
111111111111111111111111111111111111111111111111111
                                         
