NO ./wall_texture/wall_texture_north.xpm
SO ./wall_texture/wall_texture_south.xpm
WE ./wall_texture/wall_texture_west.xpm
EA ./wall_texture/wall_texture_east.xpm

F 220,100,0
C 225,30,0

1111111111111111111111111
1000000000110000000000001
1011000001110000000000001
1001000000000000000000001
1111111110110000011100001
1000000000110000011101111
111101111111110111000001
111101111111110111010001
110000001101010111000000
100000000000000011000001
100000000000000011010100
110000011101010111110N01
111101111110101101110101
111111111111111111111111
