NO ../wall_texture/wall_texture_north.xpm
SO ../wall_texture/wall_texture_south.xpm
WE ../wall_texture/wall_texture_west.xpm
EA ../wall_texture/wall_texture_east.xpm

F 220,100,0
C 225,30,0

        1111111111111111111111111
       11000000000110000000000001
    10100011000001110000000000001
    10001001000000000000000000001
111111111011000001110000000000001
100000000011000001110111111111111
11110111111111011100000010001
11110111111111011101010010001
11000000110101011100000010001
10000000000000001100000010001
10000000000000001101010010001
11000001110101011111011010N0111
11110111 1110101 101111000001
11111111 1111111 111111111111
