NO ./wall_texture/wall_texture_south.xpm
SO ./wall_texture/wall_texture_south.xpm
WE ./wall_texture/wall_texture_west.xpm
EA ./wall_texture/wall_texture_east.xpm

F 20,100,0
C 5,30,0

1111111111111111111
1000000000000000001
10000000000000N0001
1000000000000000001
1000000000000000001
1000000000000000001
1000000000000000001
1000000000000000001
1000000000000000001
1000000000000000001
1000000000000000001
1110111111111111111
