NO ./wall_texture/wall_texture_north.xpm                 
SO ./wall_texture/wall_texture_south.xpm
WE ./wall_texture/wall_texture_west.xpm
EA ./wall_texture/wall_texture_east.xpm

F 220,100,0
C 225,30,0

11111111
10000001
1000N001
100000010
100000010
10000001
1111111
